 __ __ __ __ __ __ __ __ __ __ __ __ __ __ __ __ 
|  *  *  *  *  *  *  *  *  *  *  *  *  *  *  *  |
 ** ** ** ** ** ** ** ** ** ** ** ** ** ** ** ** 
|  *  *  *  *  *  *  *  *  *  *  *  *  *  *  *  |
 ** ** ** ** ** ** ** ** ** ** ** ** ** ** ** ** 
|  *  *  *  *  *  *  *  *  *  *  *  *  *  *  *  |
 ** ** ** ** ** ** ** ** ** ** ** ** ** ** ** ** 
|  *  *  *  *  *  *  *  *  *  *  *  *  *  *  *  |
 ** ** ** ** ** ** ** ** ** ** ** ** ** ** ** ** 
|  *  *  *  *  *  *  *  *  *  *  *  *  *  *  *  |
 ** ** ** ** ** ** ** ** ** ** ** ** ** ** ** ** 
|  *  *  *  *  *  *  *  *  *  *  *  *  *  *  *  |
 ** ** ** ** ** ** ** ** ** ** ** ** ** ** ** ** 
|  *  *  *  *  *  *  * G* G*  *  *  *  *  *  *  |
 ** ** ** ** ** ** ** ** ** ** ** ** ** ** ** ** 
|  *  *  *  *  *  *  * G* G*  *  *  *  *  *  *  |
 ** ** ** ** ** ** ** ** ** ** ** ** ** ** ** ** 
|  *  *  *  *  *  *  *  *  *  *  *  *  *  *  *  |
 ** ** ** ** ** ** ** ** ** ** ** ** ** ** ** ** 
|  *  *  *  *  *  *  *  *  *  *  *  *  *  *  *  |
 ** ** ** ** ** ** ** ** ** ** ** ** ** ** ** ** 
|  *  *  *  *  *  *  *  *  *  *  *  *  *  *  *  |
 ** ** ** ** ** ** ** ** ** ** ** ** ** ** ** ** 
|  *  *  *  *  *  *  *  *  *  *  *  *  *  *  *  |
 ** ** ** ** ** ** ** ** ** ** ** ** ** ** ** ** 
|  *  *  *  *  *  *  *  *  *  *  *  *  *  *  *  |
 ** ** ** ** ** ** ** ** ** ** ** ** ** ** ** ** 
|  *  *  *  *  *  *  *  *  *  *  *  *  *  *  *  |
 ** ** ** ** ** ** ** ** ** ** ** ** ** ** ** ** 
| S|  *  *  *  *  *  *  *  *  *  *  *  *  *  *  |
 __ __ __ __ __ __ __ __ __ __ __ __ __ __ __ __ 
